Player,Ally Code,Starting Gear Needed,Progress,Current Gear Needed,Team
ZÃ©,622862641,0,0,0,Dooku+Asajj: Dooku AV
Trufra Cadav,529144446,12,1,11,Dooku+Asajj: Dooku AV G1 4*
MukiavelicK,867853565,0,0,0,Geos: GBA Poggle Geo Soldier Sun Fac Geo Spy
MukiavelicK,867853565,8,0,8,Dooku+Asajj: Dooku G7 4* AV G9
goldboy,546899719,9,0,9,Dooku+Asajj: Dooku G8 AV G7 6*
goldboy,546899719,12,0,12,Geos: GBA G10 Poggle G9 Geo Soldier G9 Sun Fac G10 Geo Spy G10
Rei do Vinho,877425459,15,14,1,Geos: GBA Poggle Geo Soldier G11 Sun Fac Geo Spy
Yoda76,447145154,0,0,0,Troopers: Veers Piett Starck Dark Trooper Range Trooper
Yoda76,447145154,0,0,0,Grievous: GG B2 B1 Droideka MagnaGuard
Yoda76,447145154,0,0,0,Dooku+Asajj: Dooku AV
Yoda76,447145154,0,0,0,Geos: GBA Poggle Geo Soldier Sun Fac Geo Spy
atuamae aossaltos,856814595,5,2,3,Dooku+Asajj: Dooku AV G9
atuamae aossaltos,856814595,15,12,3,Geos: GBA Poggle Geo Soldier Sun Fac G11 Geo Spy G10
Sirskywalker,335998436,16,12,4,Dooku+Asajj: Dooku AV G8
Sirskywalker,335998436,6,1,5,Geos: GBA G8 Poggle G11 Geo Soldier Sun Fac Geo Spy
Sal,785353312,3,3,0,Geos: GBA Poggle Geo Soldier Sun Fac Geo Spy
Sal,785353312,10,6,4,Grievous: GG G9 B2 B1 Droideka G11 MagnaGuard
Sal,785353312,8,7,1,Dooku+Asajj: Dooku G11 AV
MNSTPPT,511577167,18,3,15,Dooku+Asajj: Dooku G8 AV G1 4*
MNSTPPT,511577167,17,15,2,Geos: GBA Poggle G11 Geo Soldier Sun Fac G11 Geo Spy
Bard1313,184799421,0,0,0,Grievous: GG B2 B1 Nute MagnaGuard
Bard1313,184799421,0,0,0,Geos: GBA Poggle Geo Soldier Sun Fac Geo Spy
Bard1313,184799421,15,0,15,Troopers: Veers G8 Piett Starck G10 Dark Trooper G7 Range Trooper G8
Bard1313,184799421,1,0,1,Dooku+Asajj: Dooku G11 AV
PAM001,988613127,1,1,0,Dooku+Asajj: Dooku AV
Remus-Qui Spiuar,148289587,7,7,0,Dooku+Asajj: Dooku AV
Rafiti,726437563,0,0,0,Grievous: GG B2 B1 Droideka MagnaGuard
Rafiti,726437563,0,0,0,Dooku+Asajj: Dooku AV
Rafiti,726437563,0,0,0,Geos: GBA Poggle Geo Soldier Sun Fac Geo Spy
Noxid,941899616,0,0,0,Geos: GBA Poggle Geo Soldier Sun Fac Geo Spy
Noxid,941899616,8,8,0,Dooku+Asajj: Dooku AV
BENFIWARS,519978156,10,10,0,Geos: GBA Poggle Geo Soldier Sun Fac Geo Spy
BENFIWARS,519978156,15,1,14,Dooku+Asajj: Dooku G1 5* AV G9
Sherveen Muschifurche,954444443,9,0,9,Dooku+Asajj: Dooku G8 5* AV G7
Sherveen Muschifurche,954444443,16,1,15,Geos: GBA G9 Poggle G9 Geo Soldier G9 Sun Fac G8 Geo Spy G10
Ricklav,453915624,0,0,0,Geos: GBA Poggle Geo Soldier Sun Fac Geo Spy
Ricklav,453915624,4,0,4,Grievous: GG G8 5* B2 B1 Nute MagnaGuard
Ricklav,453915624,6,6,0,Dooku+Asajj: Dooku AV
raven85pt,827674487,15,2,13,Dooku+Asajj: Dooku G4 3* AV G7 3*
Siul Sid,362514625,0,0,0,Grievous: GG B2 B1 Droideka MagnaGuard
Siul Sid,362514625,0,0,0,Dooku+Asajj: Dooku AV
Siul Sid,362514625,0,0,0,Geos: GBA Poggle Geo Soldier Sun Fac Geo Spy
Hunabo Taduro,143746281,8,1,7,Dooku+Asajj: Dooku G9 AV G8
Romano,325633384,15,0,15,Dooku+Asajj: Dooku G8 5* AV G1 5*
Romano,325633384,2,1,1,Geos: GBA Poggle G11 Geo Soldier Sun Fac Geo Spy
