Player,Ally Code,Starting Gear Needed,Progress,Current Gear Needed,Team
AhsokaStan,464923238,0,0,0,JMK: JMK CAT GK GAS Ahsoka
AhsokaStan,464923238,0,0,0,Padme/BB: Padme Hunter Echo Tech Wrecker
AhsokaStan,464923238,8,6,2,CLS: CLS C-3PO R3 Han Chewbacca Chewpio
Markus Steel,795454584,0,0,0,JMK: JMK CAT GK GAS Ahsoka
Markus Steel,795454584,0,0,0,CLS: CLS C-3PO Han Chewbacca Chewpio
Markus Steel,795454584,1,0,1,JMLS: JMLS JKL JKR R4 GMY HYoda
Markus Steel,795454584,6,0,6,EP: EP Mara Jade, The Emperor's Hand Vader Thrawn G12 Malak
Markus Steel,795454584,45,0,45,Padme/BB: Padme G12 Hunter G7 Echo G9 Tech G9 Wrecker G8
generalAthena,469998123,40,3,37,CLS: CLS G5 C-3PO R3 Han G13 Chewbacca R1 Chewpio G5 5*
Fordy,167294499,2,2,0,CLS: CLS C-3PO Han Chewbacca Chewpio
Fordy,167294499,0,0,0,EP: EP Mara Jade, The Emperor's Hand Vader Thrawn Malak
Fordy,167294499,0,0,0,JMLS: JMLS JKL JKR GMY HYoda
Fordy,167294499,12,5,7,JMK: JMK CAT R4 GK GAS Ahsoka G12
Fordy,167294499,20,1,19,Troopers: Veers R3 Piett Dark Trooper G12 Range Trooper G9 Starck R3
Fordy,167294499,36,2,34,Padme/BB: Padme R3 Hunter G12 Echo G10 Tech G10 Wrecker G8
WhatAboutBob,697967688,9,0,9,EP: EP Mara Jade, The Emperor's Hand R2 Vader Thrawn G12 Malak
WhatAboutBob,697967688,11,0,11,CLS: CLS C-3PO R4 Han R3 Chewbacca Chewpio G10 6*
WhatAboutBob,697967688,48,7,41,Troopers: Veers G10 Piett G11 6* Dark Trooper G9 6* Range Trooper G7 5* Gideon G12
Elik Farc,168623691,6,6,0,EP: EP Mara Jade, The Emperor's Hand Vader Thrawn Malak
Elik Farc,168623691,0,0,0,CLS: CLS C-3PO Han Chewbacca Chewpio
Elik Farc,168623691,6,5,1,JMLS: JMLS JKL JKR GMY R4 HYoda
Elik Farc,168623691,17,1,16,Troopers: Veers R3 Piett Dark Trooper G9 Range Trooper R2 Starck R3
Dori Solman,811119319,30,5,25,EP: EP G12 Mara Jade, The Emperor's Hand G12 Vader Thrawn G12 RG G11
The Lone LothWolf,869485771,20,1,19,EP: EP Mara Jade, The Emperor's Hand G11 Vader Thrawn G12 Malak G12
The Lone LothWolf,869485771,39,5,34,Troopers: Veers G11 Piett Dark Trooper G8 Range Trooper G8 Starck G11
The Lone LothWolf,869485771,40,22,18,CLS: CLS R3 C-3PO R3 Han R4 Chewbacca G12 Chewpio G11
The Lone LothWolf,869485771,49,8,41,Padme/BB: Padme R3 Hunter G9 Echo G8 Tech G8 Wrecker G8
ThaPhoenix,592319272,20,20,0,CLS: CLS C-3PO Han Chewbacca Chewpio
ThaPhoenix,592319272,21,0,21,EP: EP Mara Jade, The Emperor's Hand Vader Thrawn G7 Shoretrooper G8 6*
JohnFarson,977719483,0,0,0,JMK: JMK CAT GK GAS Ahsoka
JohnFarson,977719483,0,0,0,EP: EP Mara Jade, The Emperor's Hand Vader Thrawn Malak
JohnFarson,977719483,0,0,0,CLS: CLS C-3PO Han Chewbacca Chewpio
JohnFarson,977719483,0,0,0,Padme/BB: Padme Hunter Echo Tech Wrecker
JohnFarson,977719483,1,0,1,JMLS: JMLS JKL JKR R4 GMY HYoda
JohnFarson,977719483,8,0,8,Troopers: Veers R3 Piett Dark Trooper R3 Range Trooper R3 Gideon R3
BaptizedInFilth,796155522,41,34,7,Padme/BB: Padme Hunter Echo G11 6* Tech Wrecker
BaptizedInFilth,796155522,11,0,11,EP: EP Mara Jade, The Emperor's Hand Vader Thrawn G7 Malak
BaptizedInFilth,796155522,10,3,7,CLS: CLS R4 C-3PO R2 Han Chewbacca R4 Chewpio R3
Ashtray,214716763,2,0,2,CLS: CLS R3 C-3PO Han Chewbacca Chewpio
Ashtray,214716763,5,3,2,EP: EP Mara Jade, The Emperor's Hand Vader Thrawn Malak R3
Ashtray,214716763,8,0,8,JMLS: JMLS JKL JKR R3 GMY G12 HYoda
Ashtray,214716763,19,0,19,Troopers: Veers R3 Piett Dark Trooper G9 6* Range Trooper G12 Starck R3
Ashtray,214716763,48,7,41,Padme/BB: Padme G12 Hunter G10 Echo G9 6* Tech G9 Wrecker G9
jinnergy,594398812,0,0,0,Padme/BB: Padme Hunter Echo Tech Wrecker
jinnergy,594398812,17,13,4,EP: EP Mara Jade, The Emperor's Hand R1 Vader Thrawn Malak
jinnergy,594398812,18,0,18,CLS: CLS R3 C-3PO G12 Han Chewbacca Chewpio G8
Mr Hazer,157877586,8,1,7,EP: EP Mara Jade, The Emperor's Hand R3 Vader Thrawn R3 RG R2
Fabz,486117945,0,0,0,JMK: JMK CAT GK GAS Ahsoka
Fabz,486117945,10,10,0,JMLS: JMLS JKL JKR GMY HYoda
Fabz,486117945,0,0,0,EP: EP Mara Jade, The Emperor's Hand Vader Thrawn Malak
Fabz,486117945,10,8,2,CLS: CLS R3 C-3PO Han Chewbacca Chewpio
Fabz,486117945,40,16,24,Padme/BB: Padme Hunter G12 Echo G10 Tech G12 Wrecker R1
Jakuu Bombassa,161593765,8,8,0,JMK: JMK CAT GK GAS Ahsoka
Jakuu Bombassa,161593765,1,1,0,JMLS: JMLS JKL JKR GMY HYoda
Jakuu Bombassa,161593765,9,9,0,EP: EP Mara Jade, The Emperor's Hand Vader Thrawn Malak
Jakuu Bombassa,161593765,0,0,0,CLS: CLS C-3PO Han Chewbacca Chewpio
Jakuu Bombassa,161593765,25,1,24,Troopers: Veers R3 Piett Dark Trooper G9 Range Trooper G7 Starck R3
Yog Dingham,839793419,0,0,0,CLS: CLS C-3PO Han Chewbacca Chewpio
Yog Dingham,839793419,1,0,1,JMLS: JMLS JKL JKR R4 GMY HYoda
Yog Dingham,839793419,16,13,3,EP: EP Mara Jade, The Emperor's Hand Vader Thrawn Malak R2
Yog Dingham,839793419,25,13,12,JMK: JMK CAT G12 GK GAS G12 Ahsoka
Yog Dingham,839793419,26,7,19,Troopers: Veers R3 Piett Dark Trooper G9 Range Trooper G12 Starck R3
Yog Dingham,839793419,37,0,37,Padme/BB: Padme R4 Hunter G10 Echo G9 Tech G9 Wrecker G8
Leviathan482,656451624,0,0,0,JMK: JMK CAT GK GAS Ahsoka
Leviathan482,656451624,9,9,0,JMLS: JMLS JKL JKR GMY HYoda
Leviathan482,656451624,24,24,0,CLS: CLS C-3PO Han Chewbacca Chewpio
Leviathan482,656451624,20,0,20,EP: EP Mara Jade, The Emperor's Hand Vader R3 Thrawn G10 Shoretrooper G8 6*
Shermantime,753128741,22,6,16,EP: EP Mara Jade, The Emperor's Hand G8 4* Vader Thrawn G12 Malak
Shermantime,753128741,25,5,20,CLS: CLS R1 C-3PO Han Chewbacca G12 Chewpio G8 4*
Shermantime,753128741,43,1,42,Padme/BB: Padme Hunter G7 5* Echo G8 4* Tech G8 4* Wrecker G7 5*
Dino,575659774,0,0,0,CLS: CLS C-3PO Han Chewbacca Chewpio
Dino,575659774,0,0,0,JMLS: JMLS JKL JKR GMY HYoda
Dino,575659774,4,0,4,EP: EP Mara Jade, The Emperor's Hand R1 Vader Thrawn Malak
Blibo26,459335924,23,23,0,CLS: CLS C-3PO Han Chewbacca Chewpio
Blibo26,459335924,6,4,2,EP: EP Mara Jade, The Emperor's Hand R3 Vader Thrawn Malak
Guitarman007,612313928,0,0,0,JMK: JMK CAT GK GAS Ahsoka
Guitarman007,612313928,1,1,0,SEE: SEE Malak Darth Malgus BSF DR
Guitarman007,612313928,4,4,0,CLS: CLS C-3PO Han Chewbacca Chewpio
Guitarman007,612313928,0,0,0,Padme/BB: Padme Hunter Echo Tech Wrecker
Guitarman007,612313928,12,9,3,JMLS: JMLS JKL JKR R2 GMY HYoda
Guitarman007,612313928,4,0,4,EP: EP Mara Jade, The Emperor's Hand R1 Vader Thrawn RG
Guitarman007,612313928,26,0,26,Troopers: Veers R3 Piett Dark Trooper G7 Range Trooper G7 6* Starck R3
JHall,774949483,2,2,0,CLS: CLS C-3PO Han Chewbacca Chewpio
JHall,774949483,10,10,0,JMK: JMK CAT GK GAS Ahsoka
JHall,774949483,3,0,3,JMLS: JMLS JKL JKR R2 GMY HYoda
Mogar,867575854,0,0,0,JMLS: JMLS JKL JKR GMY HYoda
Mogar,867575854,2,0,2,CLS: CLS R3 C-3PO Han Chewbacca Chewpio
Mogar,867575854,4,0,4,JMK: JMK CAT R3 GK GAS Ahsoka R3
Mogar,867575854,12,0,12,SEE: SEE Malak Darth Malgus G8 BSF R3 DR
Mogar,867575854,12,0,12,Troopers: Veers R3 Piett Dark Trooper R3 Range Trooper G12 Starck R3
Mogar,867575854,35,0,35,Padme/BB: Padme R4 Hunter G10 Echo G10 Tech G10 Wrecker G8
Tugboat Al,781217713,9,9,0,JMLS: JMLS JKL JKR GMY HYoda
Tugboat Al,781217713,6,6,0,CLS: CLS C-3PO Han Chewbacca Chewpio
Tugboat Al,781217713,30,7,23,EP: EP Mara Jade, The Emperor's Hand G5 4* Vader Thrawn G8 Malak
W1nning 101,385456932,0,0,0,EP: EP Mara Jade, The Emperor's Hand Vader Thrawn Malak
W1nning 101,385456932,28,28,0,CLS: CLS C-3PO Han Chewbacca Chewpio
W1nning 101,385456932,32,0,32,Troopers: Veers R4 Piett Dark Trooper G4 6* Range Trooper G2 Starck R4
GreenFire,219263763,10,10,0,JMLS: JMLS JKL JKR GMY HYoda
GreenFire,219263763,0,0,0,EP: EP Mara Jade, The Emperor's Hand Vader Thrawn Malak
GreenFire,219263763,1,1,0,CLS: CLS C-3PO Han Chewbacca Chewpio
GreenFire,219263763,10,8,2,JMK: JMK CAT GK GAS R3 Ahsoka
GreenFire,219263763,16,0,16,Troopers: Veers R3 Piett Dark Trooper G12 Range Trooper G12 Starck R3
GreenFire,219263763,28,4,24,Padme/BB: Padme Hunter G12 Echo G12 Tech G12 Wrecker G12
Drtic77,956912135,0,0,0,CLS: CLS C-3PO Han Chewbacca Chewpio
Drtic77,956912135,39,2,37,Troopers: Veers G12 Piett G10 Dark Trooper G7 4* Range Trooper G12 Starck G12
pikkolo,762268168,0,0,0,Padme/BB: Padme Hunter Echo Tech Wrecker
pikkolo,762268168,9,3,6,EP: EP Mara Jade, The Emperor's Hand G12 Vader Thrawn RG
pikkolo,762268168,17,5,12,CLS: CLS R3 C-3PO Han Chewbacca R3 Chewpio G10
pikkolo,762268168,25,0,25,Troopers: Veers R3 Piett Dark Trooper G7 6* Range Trooper G8 6* Starck R3
Jayskywalker,924277357,7,0,7,CLS: CLS C-3PO Han Chewbacca Chewpio G11
Fitzdorf,972276584,7,0,7,CLS: CLS C-3PO Han Chewbacca Chewpio G11 5*
Fitzdorf,972276584,12,0,12,EP: EP Mara Jade, The Emperor's Hand G9 4* Vader Thrawn Malak R2
Fitzdorf,972276584,20,7,13,JMK: JMK CAT G9 GK GAS R2 Ahsoka R4
Fitzdorf,972276584,25,0,25,Troopers: Veers R3 Piett Dark Trooper G7 6* Range Trooper G8 5* Starck R3
Fitzdorf,972276584,42,0,42,Padme/BB: Padme Hunter G7 5* Echo G8 5* Tech G8 5* Wrecker G7 5*
Utinni,257396786,0,0,0,CLS: CLS C-3PO Han Chewbacca Chewpio
Utinni,257396786,2,0,2,JMLS: JMLS JKL JKR GMY R3 HYoda
Cfood69,627548954,0,0,0,JMLS: JMLS JKL JKR GMY HYoda
Cfood69,627548954,1,0,1,CLS: CLS R4 C-3PO Han Chewbacca Chewpio
Cfood69,627548954,10,8,2,JMK: JMK CAT GK GAS Ahsoka R3
Cfood69,627548954,9,5,4,EP: EP Mara Jade, The Emperor's Hand R3 Vader Thrawn Malak R3
Cfood69,627548954,39,1,38,Padme/BB: Padme R3 Hunter G9 Echo G9 Tech G10 Wrecker G8
Dragon Reborn,396934542,30,28,2,EP: EP Mara Jade, The Emperor's Hand Vader Thrawn R3 Malak
Dragon Reborn,396934542,21,17,4,CLS: CLS C-3PO R3 Han Chewbacca Chewpio R3
Dragon Reborn,396934542,39,3,36,Padme/BB: Padme Hunter G9 Echo G9 6* Tech G9 Wrecker G9
Dragon Reborn,396934542,41,6,35,Troopers: Veers G12 Piett G10 Dark Trooper G9 Range Trooper G12 Starck G12
LordHelmet,482675979,6,6,0,JMLS: JMLS JKL JKR GMY HYoda
LordHelmet,482675979,0,0,0,CLS: CLS C-3PO Han Chewbacca Chewpio
LordHelmet,482675979,27,27,0,Padme/BB: Padme Hunter Echo Tech Wrecker
Quí Gón Jöhn,779144898,0,0,0,EP: EP Mara Jade, The Emperor's Hand Vader Thrawn Malak
Quí Gón Jöhn,779144898,26,4,22,Troopers: Veers R3 Piett Dark Trooper G11 Range Trooper G12 Gideon G11
Quí Gón Jöhn,779144898,42,0,42,CLS: CLS G12 C-3PO G8 5* Han G9 Chewbacca G9 Chewpio G10
Ren Gundo,839518948,0,0,0,CLS: CLS C-3PO Han Chewbacca Chewpio
Ren Gundo,839518948,6,0,6,JMLS: JMLS JKL JKR GMY G12 HYoda
Ren Gundo,839518948,27,1,26,EP: EP Mara Jade, The Emperor's Hand G1 Vader R4 Thrawn G12 Malak R3
Ren Gundo,839518948,48,6,42,Troopers: Veers G9 Piett G8 Dark Trooper G7 Range Trooper G12 Gideon G12
Loreck Alfonse,621255138,0,0,0,JMK: JMK CAT GK GAS Ahsoka
Loreck Alfonse,621255138,0,0,0,JMLS: JMLS JKL JKR GMY HYoda
Loreck Alfonse,621255138,11,9,2,EP: EP Mara Jade, The Emperor's Hand Vader Thrawn RG R3
Loreck Alfonse,621255138,2,0,2,CLS: CLS R3 C-3PO Han Chewbacca Chewpio
Agent P,945464958,0,0,0,CLS: CLS C-3PO Han Chewbacca Chewpio
Agent P,945464958,0,0,0,JMK: JMK CAT GK GAS Ahsoka
Agent P,945464958,1,1,0,JMLS: JMLS JKL JKR GMY HYoda
Agent P,945464958,18,18,0,Padme/BB: Padme Hunter Echo Tech Wrecker
Agent P,945464958,5,0,5,EP: EP Mara Jade, The Emperor's Hand Vader Thrawn R2 Malak R3
Agent P,945464958,32,0,32,Troopers: Veers G10 Piett Dark Trooper G9 Range Trooper G9 Gideon G12
FireEmtTV,749668594,12,1,11,EP: EP Mara Jade, The Emperor's Hand Vader Thrawn R4 RG G8
Project Chaos,868478861,2,0,2,EP: EP Mara Jade, The Emperor's Hand Vader Thrawn R3 Malak
Project Chaos,868478861,30,0,30,Padme/BB: Padme Hunter G11 Echo G10 Tech G10 Wrecker G11
Mando Kast,718375237,22,6,16,CLS: CLS R3 C-3PO Han R3 Chewbacca R3 Chewpio G8
Mando Kast,718375237,43,6,37,Padme/BB: Padme Hunter G9 Echo G9 5* Tech G9 Wrecker G8 6*
Mando Kast,718375237,50,26,24,Troopers: Veers R3 Piett R3 Dark Trooper G9 Range Trooper R3 Gideon G9
Mando Kast,718375237,36,5,31,EP: EP G13 Mara Jade, The Emperor's Hand G9 Vader R3 Thrawn G12 Malak G9
Tupacca,914194863,10,2,8,CLS: CLS R4 C-3PO R3 Han R4 Chewbacca R3 Chewpio R3
Skywolf,829847893,16,10,6,JMLS: JMLS JKL JKR GMY G12 HYoda
Skywolf,829847893,23,22,1,CLS: CLS R4 C-3PO Han Chewbacca Chewpio
Skywolf,829847893,29,2,27,EP: EP Mara Jade, The Emperor's Hand G8 4* Vader Thrawn G12 RG G7
DemToeBeanz,989314963,6,6,0,EP: EP Mara Jade, The Emperor's Hand Vader Thrawn Malak
DemToeBeanz,989314963,24,24,0,Padme/BB: Padme Hunter Echo Tech Wrecker
DemToeBeanz,989314963,16,16,0,CLS: CLS C-3PO Han Chewbacca Chewpio
DemToeBeanz,989314963,24,0,24,Troopers: Veers G12 Piett Dark Trooper G12 Range Trooper G12 Gideon G12
itsmedontusee2,335344854,0,0,0,EP: EP Mara Jade, The Emperor's Hand Vader Thrawn Malak
itsmedontusee2,335344854,0,0,0,JMK: JMK CAT GK GAS Ahsoka
itsmedontusee2,335344854,0,0,0,JMLS: JMLS JKL JKR GMY HYoda
itsmedontusee2,335344854,0,0,0,CLS: CLS C-3PO Han Chewbacca Chewpio
itsmedontusee2,335344854,10,0,10,Troopers: Veers R3 Piett Dark Trooper Range Trooper G12 Starck R3
