Player,Ally Code,Starting Gear Needed,Progress,Current Gear Needed,Team
itsmedontusee2,335344854,0,0,0,Phasma: Phasma FOTP FOSFTP FOST Kylo
itsmedontusee2,335344854,0,0,0,padme: Padme GK JKA Ahsoka CAT
itsmedontusee2,335344854,0,0,0,Grievous Omicron: GG B2 B1 MagnaGuard Droideka
itsmedontusee2,335344854,0,0,0,Negotiator: Negotiator BTL-B Y-wing Anakin's Eta-2 Rex's ARC-170 Umbaran SF Ahsoka's SF Plo's SF Clone Sergeant's ARC-170
itsmedontusee2,335344854,0,0,0,Malevolence: Malevolence Hyena Bomber Vulture Droid Sun Fac SF Soldier SF Spy SF
itsmedontusee2,335344854,16,0,16,Geonosians Omicron: GBA Sun Fac G12 Geo Soldier G12 Geo Spy G12 Poggle G12
itsmedontusee2,335344854,4,0,4,Troopers: Veers Piett Starck Dark Trooper Range Trooper G12
itsmedontusee2,335344854,0,0,0,CLS: CLS Han Chewbacca Chewpio C-3PO
itsmedontusee2,335344854,0,0,0,GAS: GAS Rex Echo (501st) Fives ARC Trooper
Cfood69,627548954,0,0,0,Phasma: Phasma FOTP FOSFTP FOST Kylo
Cfood69,627548954,0,0,0,padme: Padme GK JKA Ahsoka C-3PO
Cfood69,627548954,0,0,0,Negotiator: Negotiator BTL-B Y-wing Anakin's Eta-2 Rex's ARC-170 Umbaran SF Ahsoka's SF Plo's SF Clone Sergeant's ARC-170
Cfood69,627548954,0,0,0,CLS: CLS Han Chewbacca Chewpio R2-D2
Cfood69,627548954,7,0,7,GAS: GAS Rex R2 Echo (501st) G12 Fives R2 ARC Trooper R2
Cfood69,627548954,1,0,1,Grievous Omicron: GG B2 R2 B1 MagnaGuard Droideka
Cfood69,627548954,1,0,1,Malevolence: Malevolence Hyena Bomber 5* Vulture Droid Sun Fac SF Soldier SF Spy SF
Cfood69,627548954,8,0,8,Geonosians Omicron: GBA Sun Fac G12 Geo Soldier Geo Spy Poggle G12
Cfood69,627548954,16,0,16,Troopers: Veers Piett Starck Dark Trooper G9 Range Trooper G7 5*
Leviathan482,656451624,0,0,0,Phasma: Phasma FOTP FOSFTP FOST Kylo
Leviathan482,656451624,0,0,0,padme: Padme GK JKA Ahsoka CAT
Leviathan482,656451624,19,19,0,CLS: CLS Han Chewbacca Chewpio C-3PO
Leviathan482,656451624,5,0,5,Grievous Omicron: GG B2 B1 MagnaGuard Droideka G11
Leviathan482,656451624,1,0,1,Geonosians Omicron: GBA Sun Fac Geo Soldier Geo Spy Poggle
Leviathan482,656451624,30,4,26,GAS: GAS Rex G12 Echo (501st) G8 Fives G12 ARC Trooper G6
Blibo26,459335924,0,0,0,padme: Padme GK JKA Ahsoka C-3PO
Blibo26,459335924,32,32,0,Grievous Omicron: GG B2 B1 MagnaGuard Droideka
Blibo26,459335924,22,2,20,Geonosians Omicron: GBA G12 Sun Fac G12 Geo Soldier G12 Geo Spy G12 Poggle G12
Blibo26,459335924,19,15,4,CLS: CLS Han Chewbacca Chewpio R2-D2 G12
Blibo26,459335924,27,25,2,GAS: GAS Rex Echo (501st) R2 Fives ARC Trooper R2
Blibo26,459335924,48,47,1,Phasma: Phasma FOTP FOSFTP FOST Kylo
Blibo26,459335924,24,0,24,Troopers: Veers Piett Starck Dark Trooper G3 6* Range Trooper G5 5*
Dori Solman,811119319,20,4,16,Phasma: Phasma G12 FOE G12 Sith Trooper G12 KRU Kylo G12
Dori Solman,811119319,24,16,8,padme: Padme GK JKA G12 Ahsoka C-3PO G12
Dori Solman,811119319,23,3,20,Geonosians Omicron: GBA G12 Sun Fac G12 Geo Soldier G12 Geo Spy G12 Poggle G12
Dori Solman,811119319,43,18,25,Grievous Omicron: GG G8 B2 G11 B1 G12 MagnaGuard G12 Droideka G12
Dori Solman,811119319,48,15,33,Troopers: Veers G10 Piett G1 4* Gideon G12 Dark Trooper G12 Range Trooper G12
Dori Solman,811119319,31,2,29,CLS: CLS G12 Han G12 Chewbacca G12 Chewpio G3 4* R2-D2 G12
Tugboat Al,781217713,4,3,1,padme: Padme GK JKA R2 Ahsoka C-3PO
Tugboat Al,781217713,0,0,0,Grievous Omicron: GG B2 B1 MagnaGuard Droideka
Tugboat Al,781217713,20,5,15,Geonosians Omicron: GBA R2 Sun Fac R1 Geo Soldier G12 Geo Spy G12 Poggle G12
Tugboat Al,781217713,4,4,0,CLS: CLS Han Chewbacca Chewpio R2-D2
Tugboat Al,781217713,1,0,1,GAS: GAS Rex Echo (501st) Fives ARC Trooper R2
Tugboat Al,781217713,39,0,39,Phasma: Phasma G8 FOTP G10 FOSFTP G7 FOST G4 2* Kylo G12
Tugboat Al,781217713,1,0,1,Negotiator: Negotiator BTL-B Y-wing 3* Anakin's Eta-2 Rex's ARC-170 Umbaran SF Ahsoka's SF Plo's SF Clone Sergeant's ARC-170
Quí Gón Jöhn,779144898,18,4,14,Troopers: Veers Piett Gideon G11 Dark Trooper G11 Range Trooper G12
Quí Gón Jöhn,779144898,47,0,47,Phasma: Phasma G7 FOTP G12 FOSFTP G1 2* FOST G6 3* Kylo G7
Quí Gón Jöhn,779144898,38,6,32,padme: Padme G8 GK JKA G9 Ahsoka G7 C-3PO G8 5*
Quí Gón Jöhn,779144898,39,0,39,Grievous Omicron: GG G9 B2 G9 B1 G7 MagnaGuard G8 Droideka G8
Quí Gón Jöhn,779144898,35,0,35,Geonosians Omicron: GBA G9 Sun Fac G8 Geo Soldier G10 Geo Spy G8 Poggle G10
Quí Gón Jöhn,779144898,32,0,32,CLS: CLS G12 Han G9 Chewbacca G9 Chewpio G10 R2-D2 G8
Ren Gundo,839518948,0,0,0,Phasma: Phasma FOTP FOSFTP FOST Kylo
Ren Gundo,839518948,8,0,8,padme: Padme GK JKA G12 Ahsoka G12 C-3PO
Ren Gundo,839518948,0,0,0,Grievous Omicron: GG B2 B1 MagnaGuard Droideka
Ren Gundo,839518948,1,1,0,Negotiator: Negotiator BTL-B Y-wing Anakin's Eta-2 Rex's ARC-170 Umbaran SF Ahsoka's SF Plo's SF Clone Sergeant's ARC-170
Ren Gundo,839518948,20,0,20,Geonosians Omicron: GBA G12 Sun Fac G12 Geo Soldier G12 Geo Spy G12 Poggle G12
Ren Gundo,839518948,0,0,0,CLS: CLS Han Chewbacca Chewpio R2-D2
Ren Gundo,839518948,16,0,16,GAS: GAS Rex G12 Echo (501st) G12 Fives G12 ARC Trooper G12
Ren Gundo,839518948,1,0,1,Malevolence: Malevolence Hyena Bomber Vulture Droid 6* Sun Fac SF Soldier SF Spy SF
Ren Gundo,839518948,38,6,32,Troopers: Veers G9 Piett G8 Gideon G12 Dark Trooper G7 Range Trooper G12
sukage,767999233,0,0,0,Phasma: Phasma FOTP FOSFTP FOST Kylo
sukage,767999233,6,0,6,padme: Padme GK JKA Ahsoka G12 C-3PO R1
sukage,767999233,18,8,10,GAS: GAS Rex G12 Echo (501st) Fives G10 ARC Trooper
sukage,767999233,4,0,4,Grievous Omicron: GG B2 B1 MagnaGuard Droideka G12
sukage,767999233,22,0,22,Troopers: Veers Piett Starck Dark Trooper G1 1* Range Trooper G9
sukage,767999233,9,0,9,CLS: CLS Han Chewbacca Chewpio R2-D2 G7
Mr Hazer,157877586,4,4,0,padme: Padme GK JKA Ahsoka C-3PO
Mr Hazer,157877586,1,1,0,Negotiator: Negotiator BTL-B Y-wing Anakin's Eta-2 Rex's ARC-170 Umbaran SF Ahsoka's SF Plo's SF Clone Sergeant's ARC-170
Mr Hazer,157877586,20,8,12,Phasma: Phasma FOTP G12 FOSFTP G12 FOST G12 Kylo
Mr Hazer,157877586,31,0,31,Grievous Omicron: GG G12 B2 G9 B1 G9 MagnaGuard G9 Droideka G10
Mr Hazer,157877586,21,2,19,Geonosians Omicron: GBA G13 Sun Fac G12 Geo Soldier G12 Geo Spy G12 Poggle G12
Mr Hazer,157877586,24,1,23,CLS: CLS Han G12 Chewbacca Chewpio G1 4* R2-D2 G12
Agent P,945464958,0,0,0,padme: Padme GK JKA Ahsoka CAT
Agent P,945464958,0,0,0,Negotiator: Negotiator BTL-B Y-wing Anakin's Eta-2 Rex's ARC-170 Umbaran SF Ahsoka's SF Plo's SF Clone Sergeant's ARC-170
Agent P,945464958,0,0,0,Malevolence: Malevolence Hyena Bomber Vulture Droid Sun Fac SF Soldier SF Spy SF
Agent P,945464958,6,0,6,Geonosians Omicron: GBA Sun Fac R2 Geo Soldier Geo Spy G12 Poggle R2
Agent P,945464958,0,0,0,CLS: CLS Han Chewbacca Chewpio C-3PO
Agent P,945464958,0,0,0,GAS: GAS Rex Echo (501st) Fives ARC Trooper
Agent P,945464958,1,0,1,Phasma: Phasma FOTP FOSFTP FOST Kylo
Agent P,945464958,1,0,1,Grievous Omicron: GG B2 B1 MagnaGuard Droideka R2
Agent P,945464958,24,0,24,Troopers: Veers G10 Piett Gideon G12 Dark Trooper G9 Range Trooper G9
Skywolf,829847893,0,0,0,Phasma: Phasma FOTP FOSFTP FOST Kylo
Skywolf,829847893,20,8,12,padme: Padme G12 GK G12 JKA G12 Ahsoka C-3PO
Skywolf,829847893,20,0,20,Geonosians Omicron: GBA G12 Sun Fac G12 Geo Soldier G12 Geo Spy G12 Poggle G12
Skywolf,829847893,13,13,0,CLS: CLS Han Chewbacca Chewpio R2-D2
Skywolf,829847893,46,5,41,Grievous Omicron: GG G9 B2 G7 B1 G8 5* MagnaGuard G7 Droideka G8
Skywolf,829847893,50,3,47,Troopers: Veers G7 4* Piett G10 6* Gideon G10 Dark Trooper G5 5* Range Trooper G1 4*
WhatAboutBob,697967688,2,0,2,padme: Padme GK JKA R1 Ahsoka C-3PO
WhatAboutBob,697967688,0,0,0,Grievous Omicron: GG B2 B1 MagnaGuard Droideka
WhatAboutBob,697967688,15,5,10,GAS: GAS Rex R1 Echo (501st) R1 Fives R1 ARC Trooper G12
WhatAboutBob,697967688,24,0,24,Phasma: Phasma G12 FOTP G12 FOSFTP G12 FOST G8 3* Kylo G12
WhatAboutBob,697967688,16,0,16,Geonosians Omicron: GBA R1 Sun Fac G12 Geo Soldier R1 Geo Spy G12 Poggle G12
WhatAboutBob,697967688,38,7,31,Troopers: Veers G10 Piett G11 6* Gideon G12 Dark Trooper G9 6* Range Trooper G7 5*
WhatAboutBob,697967688,10,0,10,CLS: CLS Han Chewbacca Chewpio G10 6* R2-D2 G12
Shermantime,753128741,38,38,0,Phasma: Phasma FOTP FOSFTP FOST Kylo
Shermantime,753128741,0,0,0,padme: Padme GK JKA Ahsoka C-3PO
Shermantime,753128741,4,4,0,Grievous Omicron: GG B2 B1 MagnaGuard Droideka
Shermantime,753128741,0,0,0,GAS: GAS Rex Echo (501st) Fives ARC Trooper
Shermantime,753128741,1,0,1,Negotiator: Negotiator BTL-B Y-wing 4* Anakin's Eta-2 Rex's ARC-170 Umbaran SF Ahsoka's SF Plo's SF Clone Sergeant's ARC-170
Shermantime,753128741,4,0,4,Geonosians Omicron: GBA Sun Fac Geo Soldier Geo Spy Poggle G12
Shermantime,753128741,47,1,46,Troopers: Veers G11 Piett G7 4* Starck G7 Dark Trooper G7 5* Range Trooper G2 5*
Shermantime,753128741,23,5,18,CLS: CLS R1 Han Chewbacca G12 Chewpio G8 4* R2-D2 G12
Al,466667415,1,0,1,padme: Padme GK JKA Ahsoka R2 C-3PO
Al,466667415,1,1,0,Negotiator: Negotiator BTL-B Y-wing Anakin's Eta-2 Rex's ARC-170 Umbaran SF Ahsoka's SF Plo's SF Clone Sergeant's ARC-170
Al,466667415,0,0,0,Malevolence: Malevolence Hyena Bomber Vulture Droid Sun Fac SF Soldier SF Spy SF
Al,466667415,2,2,0,CLS: CLS Han Chewbacca Chewpio R2-D2
Al,466667415,3,0,3,GAS: GAS Rex R2 Echo (501st) R2 Fives ARC Trooper R2
Al,466667415,1,0,1,Phasma: Phasma FOTP FOSFTP FOST Kylo
Al,466667415,5,0,5,Grievous Omicron: GG R2 B2 B1 MagnaGuard G12 Droideka
Al,466667415,5,0,5,Geonosians Omicron: GBA R2 Sun Fac R2 Geo Soldier R2 Geo Spy R2 Poggle R2
Al,466667415,16,0,16,Troopers: Veers Piett Starck Dark Trooper G9 Range Trooper G7 6*
Yog Dingham,839793419,20,0,20,Phasma: Phasma G12 FOE G12 FOSFTP G12 KRU G12 Kylo G12
Yog Dingham,839793419,2,2,0,padme: Padme GK JKA Ahsoka C-3PO
Yog Dingham,839793419,1,1,0,Grievous Omicron: GG B2 B1 MagnaGuard Droideka
Yog Dingham,839793419,0,0,0,Negotiator: Negotiator BTL-B Y-wing Anakin's Eta-2 Rex's ARC-170 Umbaran SF Ahsoka's SF Plo's SF Clone Sergeant's ARC-170
Yog Dingham,839793419,0,0,0,Malevolence: Malevolence Hyena Bomber Vulture Droid Sun Fac SF Soldier SF Spy SF
Yog Dingham,839793419,10,0,10,Geonosians Omicron: GBA Sun Fac G12 Geo Soldier R2 Geo Spy R2 Poggle G12
Yog Dingham,839793419,0,0,0,CLS: CLS Han Chewbacca Chewpio R2-D2
Yog Dingham,839793419,21,3,18,GAS: GAS G12 Rex R1 Echo (501st) G12 Fives G12 ARC Trooper G12
Yog Dingham,839793419,18,7,11,Troopers: Veers Piett Starck Dark Trooper G9 Range Trooper G12
ThaPhoenix,592319272,0,0,0,padme: Padme GK JKA Ahsoka C-3PO
ThaPhoenix,592319272,0,0,0,Grievous Omicron: GG B2 B1 MagnaGuard Droideka
ThaPhoenix,592319272,0,0,0,Malevolence: Malevolence Hyena Bomber Vulture Droid Sun Fac SF Soldier SF Spy SF
ThaPhoenix,592319272,12,12,0,CLS: CLS Han Chewbacca Chewpio R2-D2
ThaPhoenix,592319272,0,0,0,GAS: GAS Rex Echo (501st) Fives ARC Trooper
ThaPhoenix,592319272,35,34,1,Phasma: Phasma FOTP FOSFTP FOST Kylo
ThaPhoenix,592319272,1,0,1,Negotiator: Negotiator BTL-B Y-wing 2* Anakin's Eta-2 Rex's ARC-170 Umbaran SF Ahsoka's SF Plo's SF Clone Sergeant's ARC-170
ThaPhoenix,592319272,3,0,3,Geonosians Omicron: GBA Sun Fac Geo Soldier Geo Spy Poggle G13
ThaPhoenix,592319272,47,3,44,Troopers: Veers G10 Piett Starck G8 Dark Trooper G1 Range Trooper G1 4*
Guitarman007,612313928,0,0,0,padme: Padme GK JKA Ahsoka CAT
Guitarman007,612313928,0,0,0,Negotiator: Negotiator BTL-B Y-wing Anakin's Eta-2 Rex's ARC-170 Umbaran SF Ahsoka's SF Plo's SF Clone Sergeant's ARC-170
Guitarman007,612313928,2,2,0,CLS: CLS Han Chewbacca Chewpio C-3PO
Guitarman007,612313928,2,0,2,GAS: GAS Rex R1 Echo (501st) Fives ARC Trooper
Guitarman007,612313928,30,2,28,Phasma: Phasma G12 FOTP G12 FOSFTP G7 FOST G7 4* Kylo R1
Guitarman007,612313928,1,0,1,Grievous Omicron: GG B2 B1 R2 MagnaGuard Droideka
Guitarman007,612313928,10,0,10,Geonosians Omicron: GBA Sun Fac G12 Geo Soldier Geo Spy R1 Poggle G12
Guitarman007,612313928,30,12,18,Troopers: Veers Piett Starck Dark Trooper G7 Range Trooper G7 6*
LordHelmet,482675979,0,0,0,padme: Padme GK JKA Ahsoka C-3PO
LordHelmet,482675979,1,1,0,Negotiator: Negotiator BTL-B Y-wing Anakin's Eta-2 Rex's ARC-170 Umbaran SF Ahsoka's SF Plo's SF Clone Sergeant's ARC-170
LordHelmet,482675979,0,0,0,CLS: CLS Han Chewbacca Chewpio R2-D2
LordHelmet,482675979,9,4,5,GAS: GAS Rex G13 Echo (501st) Fives R1 ARC Trooper
LordHelmet,482675979,1,0,1,Phasma: Phasma FOTP FOSFTP FOST Kylo
LordHelmet,482675979,4,3,1,Grievous Omicron: GG B2 B1 MagnaGuard Droideka
LordHelmet,482675979,42,0,42,Geonosians Omicron: GBA G7 6* Sun Fac G12 Geo Soldier G8 Geo Spy G5 Poggle G6
LordHelmet,482675979,23,0,23,Troopers: Veers Piett Starck Dark Trooper G3 6* Range Trooper G6 6*
pikkolo,762268168,0,0,0,padme: Padme GK JKA Ahsoka C-3PO
pikkolo,762268168,0,0,0,Negotiator: Negotiator BTL-B Y-wing Anakin's Eta-2 Rex's ARC-170 Umbaran SF Ahsoka's SF Plo's SF Clone Sergeant's ARC-170
pikkolo,762268168,0,0,0,Malevolence: Malevolence Hyena Bomber Vulture Droid Sun Fac SF Soldier SF Spy SF
pikkolo,762268168,20,10,10,CLS: CLS Han Chewbacca Chewpio G10 R2-D2 G12
pikkolo,762268168,0,0,0,GAS: GAS Rex Echo (501st) Fives ARC Trooper
pikkolo,762268168,31,0,31,Phasma: Phasma G11 FOTP G11 FOSFTP G7 FOST G9 Kylo G11
pikkolo,762268168,8,0,8,Grievous Omicron: GG B2 G12 B1 MagnaGuard Droideka G12
pikkolo,762268168,17,0,17,Geonosians Omicron: GBA G12 Sun Fac R2 Geo Soldier G12 Geo Spy G12 Poggle G12
pikkolo,762268168,17,0,17,Troopers: Veers Piett Starck Dark Trooper G7 6* Range Trooper G8 6*
Dragon Reborn,396934542,0,0,0,padme: Padme GK JKA Ahsoka CAT
Dragon Reborn,396934542,0,0,0,Negotiator: Negotiator BTL-B Y-wing Anakin's Eta-2 Rex's ARC-170 Umbaran SF Ahsoka's SF Plo's SF Clone Sergeant's ARC-170
Dragon Reborn,396934542,0,0,0,CLS: CLS Han Chewbacca Chewpio C-3PO
Dragon Reborn,396934542,20,20,0,GAS: GAS Rex Echo (501st) Fives ARC Trooper
Dragon Reborn,396934542,47,46,1,Phasma: Phasma FOTP FOSFTP FOST Kylo
Dragon Reborn,396934542,20,12,8,Grievous Omicron: GG G12 B2 B1 MagnaGuard Droideka G12
Dragon Reborn,396934542,1,0,1,Malevolence: Malevolence Hyena Bomber 4* Vulture Droid Sun Fac SF Soldier SF Spy SF
Dragon Reborn,396934542,29,3,26,Geonosians Omicron: GBA G11 Sun Fac G11 Geo Soldier G12 Geo Spy G10 Poggle G10
Dragon Reborn,396934542,31,5,26,Troopers: Veers G12 Piett G9 Starck G12 Dark Trooper G9 Range Trooper G12
Markus Steel,795454584,4,0,4,padme: Padme G12 GK JKA Ahsoka CAT
Markus Steel,795454584,0,0,0,Negotiator: Negotiator BTL-B Y-wing Anakin's Eta-2 Rex's ARC-170 Umbaran SF Ahsoka's SF Plo's SF Clone Sergeant's ARC-170
Markus Steel,795454584,0,0,0,Malevolence: Malevolence Hyena Bomber Vulture Droid Sun Fac SF Soldier SF Spy SF
Markus Steel,795454584,16,0,16,Geonosians Omicron: GBA Sun Fac G12 Geo Soldier G12 Geo Spy G12 Poggle G12
Markus Steel,795454584,0,0,0,CLS: CLS Han Chewbacca Chewpio C-3PO
Markus Steel,795454584,0,0,0,GAS: GAS Rex Echo (501st) Fives ARC Trooper
Markus Steel,795454584,8,7,1,Phasma: Phasma FOTP FOSFTP FOST Kylo
Markus Steel,795454584,8,0,8,Grievous Omicron: GG B2 G12 B1 MagnaGuard Droideka G12
Markus Steel,795454584,15,0,15,Troopers: Veers Piett Gideon Dark Trooper G1 Range Trooper
AhsokaStan,464923238,0,0,0,Phasma: Phasma FOTP FOSFTP FOST Kylo
AhsokaStan,464923238,0,0,0,padme: Padme GK JKA Ahsoka CAT
AhsokaStan,464923238,0,0,0,Negotiator: Negotiator BTL-B Y-wing Anakin's Eta-2 Rex's ARC-170 Umbaran SF Ahsoka's SF Plo's SF Clone Sergeant's ARC-170
AhsokaStan,464923238,4,4,0,CLS: CLS Han Chewbacca Chewpio C-3PO
AhsokaStan,464923238,0,0,0,GAS: GAS Rex Echo (501st) Fives ARC Trooper
AhsokaStan,464923238,2,0,2,Grievous Omicron: GG B2 R1 B1 MagnaGuard Droideka
AhsokaStan,464923238,10,0,10,Geonosians Omicron: GBA R2 Sun Fac G12 Geo Soldier R1 Geo Spy R2 Poggle R1
AhsokaStan,464923238,50,0,50,Troopers: Veers G6 5* Piett Starck G6 5* Dark Trooper G1 3* Range Trooper G1 3*
BaptizedInFilth,796155522,0,0,0,Phasma: Phasma FOTP FOSFTP FOST Kylo
BaptizedInFilth,796155522,1,1,0,padme: Padme GK JKA Ahsoka CAT
BaptizedInFilth,796155522,4,3,1,CLS: CLS Han Chewbacca Chewpio C-3PO R2
BaptizedInFilth,796155522,19,15,4,Grievous Omicron: GG B2 B1 G12 MagnaGuard Droideka
BaptizedInFilth,796155522,1,0,1,Negotiator: Negotiator BTL-B Y-wing 2* Anakin's Eta-2 Rex's ARC-170 4* Umbaran SF Ahsoka's SF Plo's SF 4* LVunit.level Clone Sergeant's ARC-170
BaptizedInFilth,796155522,20,19,1,Geonosians Omicron: GBA Sun Fac Geo Soldier Geo Spy Poggle
BaptizedInFilth,796155522,50,0,50,Troopers: Veers G8 Piett G7 Gideon G8 6* Dark Trooper G1 6* Range Trooper G6 6*
Jakuu Bombassa,161593765,0,0,0,padme: Padme GK JKA Ahsoka CAT
Jakuu Bombassa,161593765,0,0,0,Malevolence: Malevolence Hyena Bomber Vulture Droid Sun Fac SF Soldier SF Spy SF
Jakuu Bombassa,161593765,0,0,0,CLS: CLS Han Chewbacca Chewpio C-3PO
Jakuu Bombassa,161593765,29,4,25,Phasma: Phasma G12 FOTP G12 FOSFTP G7 FOST G12 Kylo G12
Jakuu Bombassa,161593765,7,0,7,Grievous Omicron: GG B2 R1 B1 R2 MagnaGuard Droideka G12
Jakuu Bombassa,161593765,1,0,1,Negotiator: Negotiator BTL-B Y-wing 4* Anakin's Eta-2 Rex's ARC-170 Umbaran SF Ahsoka's SF Plo's SF Clone Sergeant's ARC-170
Jakuu Bombassa,161593765,16,0,16,Geonosians Omicron: GBA Sun Fac G12 Geo Soldier G12 Geo Spy G12 Poggle G12
Jakuu Bombassa,161593765,17,1,16,Troopers: Veers Piett Starck Dark Trooper G9 Range Trooper G7
Jakuu Bombassa,161593765,32,3,29,GAS: GAS Rex G10 Echo (501st) G7 Fives R1 ARC Trooper G4 5*
Utinni,257396786,0,0,0,padme: Padme GK JKA Ahsoka C-3PO
Utinni,257396786,0,0,0,CLS: CLS Han Chewbacca Chewpio R2-D2
Utinni,257396786,6,0,6,GAS: GAS Rex R1 Echo (501st) R1 Fives ARC Trooper R1
Utinni,257396786,36,0,36,Phasma: Phasma G8 FOE G9 FOO G11 KRU G8 Kylo G8
Utinni,257396786,1,0,1,Grievous Omicron: GG B2 B1 MagnaGuard Droideka
Utinni,257396786,16,0,16,Geonosians Omicron: GBA Sun Fac G12 Geo Soldier G12 Geo Spy G12 Poggle G12
Utinni,257396786,30,0,30,Troopers: Veers Piett Starck Dark Trooper G1 2* Range Trooper G1 3*
Fabz,486117945,0,0,0,Phasma: Phasma FOTP FOSFTP FOST Kylo
Fabz,486117945,0,0,0,padme: Padme GK JKA Ahsoka CAT
Fabz,486117945,5,5,0,Grievous Omicron: GG B2 B1 MagnaGuard Droideka
Fabz,486117945,0,0,0,Negotiator: Negotiator BTL-B Y-wing Anakin's Eta-2 Rex's ARC-170 Umbaran SF Ahsoka's SF Plo's SF Clone Sergeant's ARC-170
Fabz,486117945,16,16,0,Geonosians Omicron: GBA Sun Fac Geo Soldier Geo Spy Poggle
Fabz,486117945,4,4,0,CLS: CLS Han Chewbacca Chewpio C-3PO
Fabz,486117945,0,0,0,GAS: GAS Rex Echo (501st) Fives ARC Trooper
Fabz,486117945,1,0,1,Malevolence: Malevolence Hyena Bomber 6* Vulture Droid 5* Sun Fac SF Soldier SF Spy SF
Fabz,486117945,30,0,30,Troopers: Veers Piett Starck Dark Trooper G1 6* Range Trooper G1 5*
Tyron Brandt,986763954,20,0,20,Geonosians Omicron: GBA G12 Sun Fac G12 Geo Soldier G12 Geo Spy G12 Poggle G12
Tyron Brandt,986763954,1,0,1,Phasma: Phasma FOTP FOSFTP FOST Kylo
Tyron Brandt,986763954,11,0,11,Grievous Omicron: GG G5 6* B2 B1 MagnaGuard Droideka
Tyron Brandt,986763954,38,0,38,CLS: CLS G12 Han G7 5* Chewbacca G7 Chewpio G7 2* R2-D2 G9
Fitzdorf,972276584,0,0,0,padme: Padme GK JKA Ahsoka C-3PO
Fitzdorf,972276584,0,0,0,Grievous Omicron: GG B2 B1 MagnaGuard Droideka
Fitzdorf,972276584,12,0,12,Geonosians Omicron: GBA Sun Fac R1 Geo Soldier G12 Geo Spy R1 Poggle G12
Fitzdorf,972276584,3,0,3,GAS: GAS R2 Rex Echo (501st) Fives ARC Trooper R1
Fitzdorf,972276584,18,0,18,Phasma: Phasma R1 FOTP G12 FOSFTP G10 FOST G12 Kylo R1
Fitzdorf,972276584,17,0,17,Troopers: Veers Piett Starck Dark Trooper G7 6* Range Trooper G8 5*
Fitzdorf,972276584,7,2,5,CLS: CLS Han Chewbacca Chewpio G11 5* R2-D2
FireEmtTV,749668594,0,0,0,Phasma: Phasma FOTP FOSFTP FOST Kylo
FireEmtTV,749668594,28,17,11,padme: Padme G10 GK JKA Ahsoka C-3PO G11
FireEmtTV,749668594,4,0,4,Grievous Omicron: GG G12 B2 B1 MagnaGuard Droideka
FireEmtTV,749668594,34,0,34,CLS: CLS Han G8 Chewbacca G9 Chewpio G1 3* R2-D2 G12
DemToeBeanz,989314963,8,8,0,padme: Padme GK JKA Ahsoka CAT
DemToeBeanz,989314963,0,0,0,Negotiator: Negotiator BTL-B Y-wing Anakin's Eta-2 Rex's ARC-170 Umbaran SF Ahsoka's SF Plo's SF Clone Sergeant's ARC-170
DemToeBeanz,989314963,0,0,0,Malevolence: Malevolence Hyena Bomber Vulture Droid Sun Fac SF Soldier SF Spy SF
DemToeBeanz,989314963,20,20,0,Geonosians Omicron: GBA Sun Fac Geo Soldier Geo Spy Poggle
DemToeBeanz,989314963,16,0,16,Troopers: Veers G12 Piett Gideon G12 Dark Trooper G12 Range Trooper G12
DemToeBeanz,989314963,8,8,0,CLS: CLS Han Chewbacca Chewpio C-3PO
DemToeBeanz,989314963,16,4,12,GAS: GAS Rex G12 Echo (501st) G12 Fives ARC Trooper G12
DemToeBeanz,989314963,48,47,1,Phasma: Phasma FOTP FOSFTP FOST Kylo
DemToeBeanz,989314963,12,11,1,Grievous Omicron: GG B2 B1 MagnaGuard Droideka
JohnFarson,977719483,0,0,0,Phasma: Phasma FOTP FOSFTP FOST Kylo
JohnFarson,977719483,0,0,0,padme: Padme GK JKA Ahsoka CAT
JohnFarson,977719483,0,0,0,Grievous Omicron: GG B2 B1 MagnaGuard Droideka
JohnFarson,977719483,0,0,0,Negotiator: Negotiator BTL-B Y-wing Anakin's Eta-2 Rex's ARC-170 Umbaran SF Ahsoka's SF Plo's SF Clone Sergeant's ARC-170
JohnFarson,977719483,1,1,0,Malevolence: Malevolence Hyena Bomber Vulture Droid Sun Fac SF Soldier SF Spy SF
JohnFarson,977719483,0,0,0,Troopers: Veers Piett Gideon Dark Trooper Range Trooper
JohnFarson,977719483,0,0,0,CLS: CLS Han Chewbacca Chewpio C-3PO
JohnFarson,977719483,0,0,0,GAS: GAS Rex Echo (501st) Fives ARC Trooper
JohnFarson,977719483,19,0,19,Geonosians Omicron: GBA R2 Sun Fac G11 Geo Soldier G12 Geo Spy G12 Poggle G11
Ashtray,214716763,0,0,0,Phasma: Phasma FOTP FOSFTP FOST Kylo
Ashtray,214716763,8,0,8,padme: Padme G12 GK JKA Ahsoka G12 C-3PO
Ashtray,214716763,0,0,0,CLS: CLS Han Chewbacca Chewpio R2-D2
Ashtray,214716763,18,1,17,Grievous Omicron: GG G12 B2 G12 B1 R2 MagnaGuard G12 Droideka G12
Ashtray,214716763,1,0,1,Negotiator: Negotiator BTL-B Y-wing 5* Anakin's Eta-2 Rex's ARC-170 Umbaran SF Ahsoka's SF Plo's SF Clone Sergeant's ARC-170
Ashtray,214716763,20,0,20,Geonosians Omicron: GBA G12 Sun Fac G12 Geo Soldier G12 Geo Spy G12 Poggle G12
Ashtray,214716763,19,8,11,Troopers: Veers Piett Starck Dark Trooper G9 6* Range Trooper G12
Ashtray,214716763,23,0,23,GAS: GAS Rex G12 Echo (501st) G11 Fives G9 ARC Trooper G9
Elik Farc,168623691,0,0,0,Phasma: Phasma FOTP FOSFTP FOST Kylo
Elik Farc,168623691,0,0,0,padme: Padme GK JKA Ahsoka C-3PO
Elik Farc,168623691,12,4,8,Grievous Omicron: GG B2 G12 B1 MagnaGuard Droideka G12
Elik Farc,168623691,1,0,1,Negotiator: Negotiator BTL-B Y-wing 6* Anakin's Eta-2 Rex's ARC-170 Umbaran SF Ahsoka's SF Plo's SF Clone Sergeant's ARC-170
Elik Farc,168623691,8,0,8,Geonosians Omicron: GBA Sun Fac G12 Geo Soldier Geo Spy Poggle G12
Elik Farc,168623691,0,0,0,CLS: CLS Han Chewbacca Chewpio R2-D2
Elik Farc,168623691,12,0,12,GAS: GAS Rex Echo (501st) G12 Fives G12 ARC Trooper G12
Elik Farc,168623691,1,0,1,Malevolence: Malevolence Hyena Bomber 5* Vulture Droid Sun Fac SF Soldier SF Spy SF
Elik Farc,168623691,9,1,8,Troopers: Veers Piett Starck Dark Trooper G9 Range Trooper R2
Jayskywalker,924277357,4,0,4,padme: Padme GK JKA G12 Ahsoka C-3PO
Jayskywalker,924277357,0,0,0,Negotiator: Negotiator BTL-B Y-wing Anakin's Eta-2 Rex's ARC-170 Umbaran SF Ahsoka's SF Plo's SF Clone Sergeant's ARC-170
Jayskywalker,924277357,5,0,5,CLS: CLS Han Chewbacca Chewpio G11 R2-D2
Jayskywalker,924277357,17,8,9,GAS: GAS Rex R1 Echo (501st) R1 Fives R1 ARC Trooper G13
Jayskywalker,924277357,42,11,31,Phasma: Phasma G12 FOTP G11 FOSFTP G1 FOST G12 Kylo G13
Jayskywalker,924277357,1,0,1,Grievous Omicron: GG B2 B1 MagnaGuard Droideka
Jayskywalker,924277357,1,0,1,Malevolence: Malevolence Hyena Bomber 4* Vulture Droid 3* Sun Fac SF Soldier SF Spy SF
Jayskywalker,924277357,28,1,27,Geonosians Omicron: GBA G11 Sun Fac G9 Geo Soldier G12 Geo Spy G9 Poggle G12
Mando Kast,718375237,14,11,3,padme: Padme GK JKA R2 Ahsoka R1 C-3PO
Mando Kast,718375237,30,10,20,Geonosians Omicron: GBA G12 Sun Fac G12 Geo Soldier G12 Geo Spy G12 Poggle G12
Mando Kast,718375237,40,21,19,GAS: GAS Rex G12 Echo (501st) G11 Fives G12 ARC Trooper G10
Mando Kast,718375237,47,12,35,Phasma: Phasma G9 FOTP G11 FOSFTP G8 FOST G9 Kylo G8
Mando Kast,718375237,20,4,16,Grievous Omicron: GG G12 B2 G12 B1 G12 MagnaGuard G12 Droideka
Mando Kast,718375237,1,0,1,Negotiator: Negotiator BTL-B Y-wing 2* Anakin's Eta-2 Rex's ARC-170 Umbaran SF Ahsoka's SF Plo's SF Clone Sergeant's ARC-170
Mando Kast,718375237,41,27,14,Troopers: Veers Piett Gideon G9 Dark Trooper G9 Range Trooper
Mando Kast,718375237,21,5,16,CLS: CLS Han Chewbacca Chewpio G8 R2-D2 G8
GreenFire,219263763,0,0,0,padme: Padme GK JKA Ahsoka CAT
GreenFire,219263763,8,0,8,Troopers: Veers Piett Starck Dark Trooper G12 Range Trooper G12
GreenFire,219263763,0,0,0,CLS: CLS Han Chewbacca Chewpio C-3PO
GreenFire,219263763,16,16,0,GAS: GAS Rex Echo (501st) Fives ARC Trooper
GreenFire,219263763,1,0,1,Phasma: Phasma FOTP FOSFTP FOST Kylo
GreenFire,219263763,1,0,1,Grievous Omicron: GG B2 B1 MagnaGuard Droideka
GreenFire,219263763,1,0,1,Negotiator: Negotiator BTL-B Y-wing 4* Anakin's Eta-2 Rex's ARC-170 Umbaran SF Ahsoka's SF Plo's SF Clone Sergeant's ARC-170
GreenFire,219263763,20,19,1,Geonosians Omicron: GBA Sun Fac Geo Soldier Geo Spy Poggle
jinnergy,594398812,10,2,8,padme: Padme GK JKA Ahsoka G12 C-3PO G12
jinnergy,594398812,12,0,12,CLS: CLS Han Chewbacca Chewpio G8 R2-D2 G12
jinnergy,594398812,10,2,8,GAS: GAS Rex G12 Echo (501st) Fives G12 ARC Trooper
jinnergy,594398812,41,0,41,Phasma: Phasma G8 FOTP G10 FOSFTP G1 3* FOST G8 Kylo G12
jinnergy,594398812,14,0,14,Grievous Omicron: GG G12 B2 B1 MagnaGuard G10 Droideka G12
jinnergy,594398812,1,0,1,Negotiator: Negotiator BTL-B Y-wing Anakin's Eta-2 Rex's ARC-170 4* Umbaran SF Ahsoka's SF Plo's SF Clone Sergeant's ARC-170
jinnergy,594398812,29,3,26,Geonosians Omicron: GBA G12 Sun Fac G9 Geo Soldier G12 Geo Spy G10 Poggle G11
jinnergy,594398812,35,16,19,Troopers: Veers Piett Starck Dark Trooper G1 6* Range Trooper G12
QuinWindu,979638921,37,37,0,Phasma: Phasma FOTP FOSFTP FOST Kylo
QuinWindu,979638921,40,10,30,padme: Padme G8 GK G7 JKA G12 Ahsoka C-3PO G7
QuinWindu,979638921,46,0,46,Grievous Omicron: GG G5 6* B2 G5 6* B1 G5 4* MagnaGuard G12 Droideka G7
QuinWindu,979638921,40,1,39,Geonosians Omicron: GBA G7 6* Sun Fac G6 Geo Soldier G8 Geo Spy G8 Poggle G12
QuinWindu,979638921,43,0,43,Troopers: Veers G9 5* Piett G5 2* Gideon G12 Dark Trooper G7 6* Range Trooper G4 3*
QuinWindu,979638921,40,13,27,CLS: CLS Han G11 Chewbacca G9 Chewpio G7 5* R2-D2 G10
W1nning 101,385456932,19,19,0,padme: Padme GK JKA Ahsoka CAT
W1nning 101,385456932,37,27,10,Grievous Omicron: GG B2 R2 B1 G12 MagnaGuard G11 Droideka
W1nning 101,385456932,12,3,9,Geonosians Omicron: GBA Sun Fac G12 Geo Soldier G12 Geo Spy R2 Poggle
W1nning 101,385456932,45,45,0,CLS: CLS Han Chewbacca Chewpio C-3PO
W1nning 101,385456932,23,0,23,Phasma: Phasma G12 FOTP G12 FOSFTP G9 FOST G8 5* Kylo
W1nning 101,385456932,26,0,26,Troopers: Veers Piett Starck Dark Trooper G4 6* Range Trooper G2
W1nning 101,385456932,31,9,22,GAS: GAS G11 Rex Echo (501st) G12 Fives ARC Trooper G3 4*
Tupacca,914194863,4,0,4,padme: Padme GK JKA G12 Ahsoka C-3PO
Tupacca,914194863,20,0,20,Geonosians Omicron: GBA G12 Sun Fac G12 Geo Soldier G12 Geo Spy G12 Poggle G12
Tupacca,914194863,4,0,4,CLS: CLS Han Chewbacca Chewpio R2-D2 G12
Tupacca,914194863,0,0,0,GAS: GAS Rex Echo (501st) Fives ARC Trooper
Tupacca,914194863,37,0,37,Phasma: Phasma G7 FOTP G10 FOO G8 KRU G9 Kylo G9
Tupacca,914194863,12,0,12,Grievous Omicron: GG G12 B2 B1 G12 MagnaGuard Droideka G12
Tupacca,914194863,49,0,49,Troopers: Veers G8 6* Piett G2 3* Gideon G9 5* Dark Trooper G5 5* Range Trooper G7
TinyToebeans,182866389,16,13,3,padme: Padme GK JKA Ahsoka C-3PO G13
TinyToebeans,182866389,20,3,17,Geonosians Omicron: GBA R2 Sun Fac G12 Geo Soldier G12 Geo Spy G12 Poggle G12
TinyToebeans,182866389,24,23,1,Phasma: Phasma FOTP FOSFTP FOST Kylo
TinyToebeans,182866389,46,42,4,Grievous Omicron: GG G12 B2 B1 MagnaGuard Droideka
TinyToebeans,182866389,20,2,18,GAS: GAS G10 6* Rex G12 Echo (501st) G12 Fives ARC Trooper G12
Mogar,867575854,0,0,0,Phasma: Phasma FOTP FOSFTP FOST Kylo
Mogar,867575854,0,0,0,padme: Padme GK JKA Ahsoka C-3PO
Mogar,867575854,0,0,0,Grievous Omicron: GG B2 B1 MagnaGuard Droideka
Mogar,867575854,0,0,0,Negotiator: Negotiator BTL-B Y-wing Anakin's Eta-2 Rex's ARC-170 Umbaran SF Ahsoka's SF Plo's SF Clone Sergeant's ARC-170
Mogar,867575854,0,0,0,Malevolence: Malevolence Hyena Bomber Vulture Droid Sun Fac SF Soldier SF Spy SF
Mogar,867575854,4,0,4,Troopers: Veers Piett Starck Dark Trooper Range Trooper G12
Mogar,867575854,0,0,0,CLS: CLS Han Chewbacca Chewpio R2-D2
Mogar,867575854,16,0,16,GAS: GAS Rex G12 Echo (501st) G12 Fives G12 ARC Trooper G12
Mogar,867575854,20,0,20,Geonosians Omicron: GBA G12 Sun Fac G12 Geo Soldier G12 Geo Spy G12 Poggle G12
generalAthena,469998123,6,2,4,padme: Padme R2 GK JKA R1 Ahsoka C-3PO R2
generalAthena,469998123,1,1,0,Geonosians Omicron: GBA Sun Fac Geo Soldier Geo Spy Poggle
generalAthena,469998123,34,16,18,Phasma: Phasma R1 FOTP G13 FOSFTP G8 FOST G11 6* Kylo
generalAthena,469998123,1,0,1,Negotiator: Negotiator BTL-B Y-wing 5* Anakin's Eta-2 Rex's ARC-170 Umbaran SF Ahsoka's SF Plo's SF Clone Sergeant's ARC-170
generalAthena,469998123,42,8,34,Grievous Omicron: GG G13 B2 G5 B1 R2 MagnaGuard G5 Droideka G8
generalAthena,469998123,31,1,30,CLS: CLS G5 Han G13 Chewbacca R1 Chewpio G5 5* R2-D2 G13
Project Chaos,868478861,0,0,0,padme: Padme GK JKA Ahsoka CAT
Project Chaos,868478861,0,0,0,Negotiator: Negotiator BTL-B Y-wing Anakin's Eta-2 Rex's ARC-170 Umbaran SF Ahsoka's SF Plo's SF Clone Sergeant's ARC-170
Project Chaos,868478861,4,0,4,GAS: GAS Rex Echo (501st) Fives ARC Trooper G12
Project Chaos,868478861,42,41,1,Phasma: Phasma FOTP FOSFTP FOST Kylo
Project Chaos,868478861,6,0,6,Grievous Omicron: GG B2 R2 B1 MagnaGuard G12 Droideka R2
Project Chaos,868478861,1,0,1,Malevolence: Malevolence Hyena Bomber 5* Vulture Droid Sun Fac SF Soldier SF Spy SF
Project Chaos,868478861,20,0,20,Geonosians Omicron: GBA G12 Sun Fac G12 Geo Soldier G12 Geo Spy G12 Poggle G12
Project Chaos,868478861,43,2,41,Troopers: Veers G8 Piett G10 Starck G10 Dark Trooper G1 1* Range Trooper G10 6*
Fordy,167294499,0,0,0,Phasma: Phasma FOTP FOSFTP FOST Kylo
Fordy,167294499,4,0,4,padme: Padme GK JKA Ahsoka G12 C-3PO
Fordy,167294499,0,0,0,Negotiator: Negotiator BTL-B Y-wing Anakin's Eta-2 Rex's ARC-170 Umbaran SF Ahsoka's SF Plo's SF Clone Sergeant's ARC-170
Fordy,167294499,1,1,0,Malevolence: Malevolence Hyena Bomber Vulture Droid Sun Fac SF Soldier SF Spy SF
Fordy,167294499,0,0,0,CLS: CLS Han Chewbacca Chewpio R2-D2
Fordy,167294499,0,0,0,GAS: GAS Rex Echo (501st) Fives ARC Trooper
Fordy,167294499,1,0,1,Grievous Omicron: GG B2 B1 MagnaGuard Droideka
Fordy,167294499,2,0,2,Geonosians Omicron: GBA Sun Fac Geo Soldier R1 Geo Spy Poggle
Fordy,167294499,12,1,11,Troopers: Veers Piett Starck Dark Trooper G12 Range Trooper G9
JHall,774949483,0,0,0,padme: Padme GK JKA Ahsoka CAT
JHall,774949483,0,0,0,Negotiator: Negotiator BTL-B Y-wing Anakin's Eta-2 Rex's ARC-170 Umbaran SF Ahsoka's SF Plo's SF Clone Sergeant's ARC-170
JHall,774949483,0,0,0,CLS: CLS Han Chewbacca Chewpio C-3PO
JHall,774949483,13,0,13,GAS: GAS Rex G12 Echo (501st) G12 Fives R2 ARC Trooper G12
JHall,774949483,38,37,1,Phasma: Phasma FOTP FOSFTP FOST Kylo
JHall,774949483,8,0,8,Grievous Omicron: GG B2 G12 B1 MagnaGuard Droideka G12
JHall,774949483,26,0,26,Geonosians Omicron: GBA G11 Sun Fac G10 Geo Soldier G11 Geo Spy G11 Poggle G11
JHall,774949483,46,0,46,Troopers: Veers G12 Piett G10 Starck G10 Dark Trooper G1 5* Range Trooper G1 4*
Drtic77,956912135,0,0,0,Phasma: Phasma FOTP FOSFTP FOST Kylo
Drtic77,956912135,9,1,8,padme: Padme G12 GK JKA Ahsoka G12 C-3PO
Drtic77,956912135,20,0,20,Geonosians Omicron: GBA G12 Sun Fac G12 Geo Soldier G12 Geo Spy G12 Poggle G12
Drtic77,956912135,0,0,0,CLS: CLS Han Chewbacca Chewpio R2-D2
Drtic77,956912135,22,2,20,GAS: GAS G12 Rex G12 Echo (501st) G12 Fives G12 ARC Trooper G12
Drtic77,956912135,16,0,16,Grievous Omicron: GG G12 B2 G13 B1 G13 MagnaGuard G13 Droideka G13
Drtic77,956912135,1,0,1,Negotiator: Negotiator BTL-B Y-wing 5* Anakin's Eta-2 Rex's ARC-170 Umbaran SF Ahsoka's SF Plo's SF Clone Sergeant's ARC-170
Drtic77,956912135,29,2,27,Troopers: Veers G12 Piett G10 Starck G12 Dark Trooper G7 4* Range Trooper G12
Loreck Alfonse,621255138,0,0,0,padme: Padme GK JKA Ahsoka CAT
Loreck Alfonse,621255138,0,0,0,Grievous Omicron: GG B2 B1 MagnaGuard Droideka
Loreck Alfonse,621255138,0,0,0,Malevolence: Malevolence Hyena Bomber Vulture Droid Sun Fac SF Soldier SF Spy SF
Loreck Alfonse,621255138,9,0,9,Geonosians Omicron: GBA Sun Fac Geo Soldier G13 Geo Spy G13 Poggle G13
Loreck Alfonse,621255138,0,0,0,CLS: CLS Han Chewbacca Chewpio C-3PO
Loreck Alfonse,621255138,4,0,4,GAS: GAS Rex R2 Echo (501st) R2 Fives R2 ARC Trooper R2
Loreck Alfonse,621255138,45,0,45,Phasma: Phasma G11 FOTP G11 FOSFTP G1 FOST G1 Kylo G11
Loreck Alfonse,621255138,1,0,1,Negotiator: Negotiator BTL-B Y-wing 4* Anakin's Eta-2 Rex's ARC-170 Umbaran SF Ahsoka's SF Plo's SF Clone Sergeant's ARC-170
Loreck Alfonse,621255138,18,0,18,Troopers: Veers Piett Gideon Dark Trooper G1 6* Range Trooper G13
The Lone LothWolf,869485771,27,23,4,padme: Padme GK JKA G12 Ahsoka C-3PO
The Lone LothWolf,869485771,0,0,0,Negotiator: Negotiator BTL-B Y-wing Anakin's Eta-2 Rex's ARC-170 Umbaran SF Ahsoka's SF Plo's SF Clone Sergeant's ARC-170
The Lone LothWolf,869485771,1,1,0,Malevolence: Malevolence Hyena Bomber Vulture Droid Sun Fac SF Soldier SF Spy SF
The Lone LothWolf,869485771,20,20,0,Geonosians Omicron: GBA Sun Fac Geo Soldier Geo Spy Poggle
The Lone LothWolf,869485771,25,12,13,CLS: CLS Han Chewbacca G12 Chewpio G11 R2-D2 G12
The Lone LothWolf,869485771,40,39,1,Phasma: Phasma FOTP FOSFTP FOST Kylo
The Lone LothWolf,869485771,38,34,4,Grievous Omicron: GG G12 B2 B1 MagnaGuard Droideka
The Lone LothWolf,869485771,31,5,26,Troopers: Veers G11 Piett Starck G11 Dark Trooper G8 Range Trooper G8
